NO ./textures/trial_images/black_space.xpm
SO ./textures/trial_images/brick.xpm
WE ./textures/trial_images/chip.xpm   
EA ./textures/trial_images/dual_squares.xpm

F 20,20,20
C 22,0,44

1111111111111111111
1000000000000000001
10000000W0000000001
1000000000000000001
1000000000000000001
1000000000000000001
1000000000000000001
1111111111111111111